
NO ./textures/wall_n.xpm    
WE ./textures/wall_w.xpm
SO ./img/among-us-red-shakes-booty.xpm
EA ./img/among-us-red-shakes-booty.xpm


C 135, 255, 255
F 130, 170, 50

asdfadsf

11111111111111111
10000000000000001
10000000000000001
10000d000000000001
10000011000000001
1000000000000001
10010000000000001
11111000000S00001
10000000000000001
11111000000000001
10000000000000001
10000000000000001
11111111111111111


gfhhgfgjhfg