NO ./textures/wall_n.xpm
WE ./textures/wall_w.xpm
SO ./textures/wall_s.xpm
EA ./textures/wall_e.xpm

F 130, 70, 0
C 135, 206, 235

11111111
10000001
10011001
10000001
1001P001
10000001
10000001
10000001
10011001
10000001
11111111