NO ./textures/wall_n.xpm
WE ./textures/wall_w.xpm
SO ./textures/wall_s.xpm
EA ./textures/wall_e.xpm


F 130, 70, 250
C 135, 255, 235

11111111 111111111
10000001 100000001
10011001 100000001
10000001 100000001
10010001 100000001
100000001 100000001
100000N1 100000001
10000001 100000001
10011001 100000001
10000001 100000001
11111111 111111111
