
NO ./textures/wall_n.xpm    
WE ./textures/wall_w.xpm
SO ./img/among-us-red-shakes-booty.xpm
EA ./img/among-us-red-shakes-booty.xpm


C 135, 255, 255
F 130, 170, 50

11111111111111111
10000001100000001
10000001100000001
10000001100000001
10010001100000001
111111111100001111
100100000000000001
100E00000000000011
100000011100000001
10000001 100000001
10011001 100000001
10000001 10000001
11111111 111111111