NO ./textures/wall_n.xpm
WE ./textures/wall_w.xpm
SO ./textures/wall_s.xpm
EA ./textures/wall_e.xpm


F 130, 170, 250
C 135, 255, 255

11111111111111111
10000001100000001
10011001100000001
10000001100000001
100100011000000001
100000000000W000001
100000011100000001
10000001 100000001
10011001 100000001
10000001 100000001
11111111 111111111
